########################################
#**************************************#
######################################*#
#************************************#*#
#*##################################*#*#
#*#********************************#*#*#
#*#*##############################*#*#*#
#*#*#******************************#*#*#
#*#*#******************************#*#*#
#*#*#******************************#*#*#
#*#*#******************************#*#*#
#*#*#******************************#*#*#
#*#*#******************************#*#*#
#*#*#******************************#*#*#
#*#*#******************************#*#*#
#*#*################################*#*#
#*#**********************************#*#
#*####################################*#
#**************************************#
########################################
