######_________________#################
#***************************************
########*#############################*#
*************************************#*#
#*######*###########################*#*#
#*#********************************#*#*#
#*#*####*#########################*#*#*#
#*#*#**#*#****#***********#********#*#*#
#*#*#**#*#****#*########**#*######*#*#*#
#*#*#**#*######*#*********#*#****#*#*#*#
#*#*#**#********#*#########*#**#*#*#*#*#
#*#*#**##########*#*********#**#*#*#*#*#
#*#*#*************#*#########**#*#*#*#*#
#*#*#*#############*###**###***###*#*#*#
#*#*#***************#********#*****#*#*#
#*#*##################*#############*#*#
#*#******************#*#*************#*#
#*####################*###############*#
#**************************************#
########################################
